WWWWWWWWWWWWWWWWWWWWWWWWWWWWWWWWWWWWWW                                                                                     
W                                    WWW             WWWWWWWWWWWWWWWWWWWWWWWWWWWWWWWWWWWWWWWWWWWWWWWWWWWWWWWWWWWWWWWWWWWWWW
               WW                      WWWWWWWWWWWWWW                        B   R  G        B       R  GG       R        W
 A           WWWW                                             WXW         W  B R G    BBGG   B  G    GG    RRB   G    GRB W 
WWWWWWWWWWWWWWWWWRRRRRRRRRRRRRRRRWWWW               WX                 XWWR  G B GBBB RR R   B  GRRG   RR    GZ  R GRB    W 
W                                        X  WWZ           WC    ZW W W    W    B         R   B     G     BB BBR  G      < W
W              WW                                                         W  BGG RRGG BBBBRR GGRRB  GGRR      R XR     CG W
WS           WWWW                          CWW     CWW       XWW  WWZ     B  R     B     G        R    BRRRGGBB  G    XGB W
WWWWWWWWWWWWWWWWWGGGGGGGGGGGGGGGGWWWW                                     W  G  B  R  G  B  R  G  B  R BR     R  R   ZBRR W
                                          X W  CW        ZWWWWWWWC       <G  G  B  R  G  B  R  G     R    WWWWRC    CRGGGMW
               WW                      WWWWWWWWWWWWWWRRGGBBRRGGBBRRGGBBWWWWBBGRRBGGRBBGRRBGGRBBGRRBGGRWWWWWWWWWWWWWWWWWWWWW
 D           WWWW                    WWW                                                                                   
 WWWWWWWWWWWWWWWWBBBBBBBBBBBBBBBBWWWWW                                                                                     %

