W                            W                           WWW
W                            W                         WW  W
W           WWW              W                       WW    W
W                            W                     WW      W
W                            W                   WW        W
W                            W                 WW          W
W        WWW                 W               WW            W
W                            W             WW              W
W     WWW                    W           WW                W
W                XXXX        W         WW                  W
W                            W       WW                    W
WWWWWWWWWWWWWWWWWWWWWWWWWWWWWWWWWWWWWWWWWWWWWWWWWWWWWWWWWWWW%
