W                            W                           WWW
W                            W                         WW  W
W           GGG              W                       WW    W
W                            R                     WW      W
W                            R                   WW        W
W                            R                 WW          W
W        GGG                 R               WW            W
W                            R             WW              W
W     GGG                    R           WW                W
W                XXXX        R         WW                  W
W                            W       WW                    W
WWWWWWWWWBBBBBBBBBBBWWWWWWWWWWWWWWWWWWWWWWWWWWWWWWWWWWWWWWWW%
