WWWWWWWWWWWWWWWWWWWWWWWWWWWWWWWWWWWWWW                                                                                 
W                                    WWW                                                                               
W              WW                      WWWWWWWWWWWWWW                                                                 W
WA           WWWW                                                                                                     W
WWWWWWWWWWWWWWWWWRRRRRRRRRRRRRRRRWWWW                                                                                 WWWWW
W                                                                                                                         W
W              WW                                                                                                 WWWW    W
WS           WWWW                                                                                             WWWWWWWWWWWWW
WWWWWWWWWWWWWWWWWGGGGGGGGGGGGGGGGWWWW                                     W  G  B  R  G  B  R  G  B  R                    W
W                                                                         W  G  B  R  G  B  R  G  B  R    WWWW            W
W              WW                      WWWWWWWWWWWWWWRRGGBBRRGGBBRRGGBBWWWWBBGRRBGGRBBGRRBGGRBBGRRBGGRWWWWWWWWWWWWWWWWWWWWW
WD           WWWW                    WWW                                                                                   
WWWWWWWWWWWWWWWWWBBBBBBBBBBBBBBBBWWWWW                                                                                     %
