WWWWWWWWWWWWWWWWWWWW
W                  W
W                  W
W                  W
W <  <X  <Z  < C < W
W GBBBBBBBBBGGBBRR W
W G                W
W GZZXCW   BWWWWWWBW
W     W   B      BBW
W X  W   B  G    WBW
W   W   B  G   R W W
W   W  B  G   RB W W
W X W    G   RB  W W
W   W   G   RB   W W
W M W  G   RB    W W
W<W<WGG   RB     W W
W        RB      W W
WASD    RBBCCCCCC  W
WWWWWWWWWWWWWWWWWWWW%
