WWWWWWWWWWWWWWWWWWWWWWWWWWWWWWWWWWWWWW                                  
W                                    WWW                                
W              WW                      WWWWWWWWWWWWWWWWWWWWWWW         W
WA           WWWW                                                      W
WWWWWWWWWWWWWWWWWRRRRRRRRRRRRRRRRWWWW                                  W
W                                                                      W
W              WW                                                      W
WS           WWWW                                                      W
WWWWWWWWWWWWWWWWWGGGGGGGGGGGGGGGGWWWW                                  W
W                                                                      W
W              WW                      WWWWWWWWWWWWWWRRGGBBRRGGBBRRGGBBW
WD           WWWW                    WWW                                
WWWWWWWWWWWWWWWWWBBBBBBBBBBBBBBBBWWWWW                                  %
