WWWWWWWWWWWWWWWWWW
W                W
W                W
W       M        W
W     ZWWWC      W
W XG       R     W
W     GC     BR  W
WB  R   B   G   RW
W                W
W G   G   B   G  W
W           RR   W
W   B           BW
W      RG      X W
WRR        GG    W
W   GG           W
W       ZR     BCW
W Z         G    W
W    GG          W
W                W
W BB     GG   RXRW
W                W
W    XR          W
W         B      W
WRB     G      GGW
W    X      X    W
WD  RRR  S BBB  AW
WWWWWWWWWWWWWWWWWW%
