WWWWWWWWWW
W        W
WA  S   DW
WW  W   WW
W        W
W        W
WX Z C X W
W        W
W        W
WZZ  CCXXW
W        W
W        W
WCCXX  ZZW
W        W
W        W
WXXZZCC  W
W        W
W        W
W        W
WZZ  CCXXW
W        W
W        W
WCC  XXZZW
W        W
W        W
W        W
W  CCZZXXW
W        W
W        W
WZZ      W
W    M   W
WWWWWWWWWW%
